BBSBBBBBBBBBBBB
BX.X          B
B .   ......  B
B .   .    .  B
B .   .    .  B
B .   .    .  B
B .   .   X.X B
B .....   XPX B
B         XXX B
BBBBBBBBBBBBBBB